111111111111111111
1P00000000000000M1
100000000000000001
100000000000000001
100000000000000001
1C0000000000000001
100000000000000001
100000000000000001
10C00000000E0000M1
111111111111111111