1111111111111111111111111111111111
1P0000000C000000000000000M000C00E1
1000010100100000101001000000010101
1000010010101010001001000000010101
101000000C00000000000000M0000000C1
1010C00000000000000000000000000001
1111111111111111111111111111111111