111111111111111111111111111
1P00C0000000010000CC1111111
100000000010010000001111111
111111110010M100M0001111111
111111110000000000000111111
111111110000000000000111111
111111110000011000000111111
111111110000011000M00111111
111111110000011000000111111
111111110000111000M00111111
111111110000111000000111111
1111111100000C1100000111111
111111110001111100000111111
11111111C0000C00C000E111111
111111111111111111111111111