111111111111111
1P00000001100C1
100001000000001
110011001011101
100001000001001
1M00000M0000CE1
111111111111111