11111111111111111111111111111111111111
1100000000000000000000C1111000000000E1
1100000000000000M000000111100000000001
1P000000000000111100000011C00000000001
1100000000000011111C00001100000000M111
11001111110000111111100001000000011111
11001111111000111111110001000001111111
11001111111000111111100001000011111111
110011100000000C1111000001000011111111
1100C000000000000011000001000001111111
11000000000000000000M0000000000000C111
1100M000000000000C11111100000000M00111
11C0000000M00000011111111C000000001111
11111111111111111111111111111111111111