111111111111111111111111111111111111111111111111
1100000000000000000000C1111000000000000000000001
1100000000000000M0000001111000000000000000000001
1P00000000000011110000001100000C0000000000000001
1000000000000011111C0000110000000001100000000001
100011111100000000000000010000000111100000000001
110011111110000000000000010000011111100000000001
110011111110001111111000010000111111100000000001
110010000000000C11110000010000111111100000000001
1100C0000000000000110000010000011111100000000001
1100000000000000000000000000000000C1100000000001
1100M000000000000C111111M0000000M001100000000001
11C0000000M00000011111111C0000000E11100000000001
1100C0000000000000110000010000011111100000000001
1100000000000000000000000000000000C1100000000001
1100M000000000000C111111M0000000M001100000000001
11C0000000M00000011111111C0000000E11100000000001
1100C0000000000000110000010000011111100000000001
1100000000000000000000000000000000C1100000000001
1100M000000000000C000000M0000000M001100000000001
11C0000000M00000000000000C0000000E11100000000001
1100C0000000000000000000010000011111100000000001
1100000000000000000000000000000000C1100000000001
1100M0000000000000000001M0000000M001100000000001
11C0000000M00000000000000C0000000E11100000000001
111111111111111111111111111111111111111111111111